WWWWWWWWWWWWWWWWWWWW
Wb...H............bW
W..................W
W..................W
W.......A..........W 
W.........T........W 
W..................W
W..................W
W..................W
W..................W
W..................W
W..................W
W..................W
W..................W
WWWWWWWWEEWWWWWWWWWW