WWWWWWWWWWWWWWWWWWWW
W..................W
W..................W
W...S...H...A......W
W..................W
W....Z...T...Z.....W 
W..................W
W..................W
W..................W
W..................W
WWWWWWWWEEWWWWWWWWWW